{
    "winningPoints": 1,

    "lower": {
        "_": "0 1 2 3 4 5 6 7 8 9 A B C D E F",
        "0": ". . . . . . . . . . . . . . . .",
        "1": ". . . . . . . . . . . . . . . .",
        "2": ". . . . . . . . . . . . . . . .",
        "3": ". . . . . . . . . . . . . . . .",
        "4": ". . . . . . . . . . . . . . . .",
        "5": ". . . . . s s . . . . . . . . .",
        "6": ". . . . . s s . . . . . . . . .",
        "7": ". . . s s s s . s s s s s . . .",
        "8": ". . . . . . . . . . . . . . . .",
        "9": ". . . . . . . . . . . . . . . .",
        "A": ". . . . . . . . . . . . . . . .",
        "B": ". . . . . . . . . . . . . . . .",
        "C": ". . . . . . . . . . . . . . . .",
        "D": ". . . . . . . . . . . . . . . .",
        "E": ". . . . . . . . . . . . . . . .",
        "F": ". . . . . . . . . . . . . . . ."
    },

    "upper": {
        "_": "0 1 2 3 4 5 6 7 8 9 A B C D E F",
        "0": ". . . . . . . . . . . . . . . .",
        "1": ". . . . . . . . . . . . . . . .",
        "2": ". . . . . . . . . . . . . . . .",
        "3": ". . . . . . . . . . . . . . . .",
        "4": ". . . . . . . . . . . . . . . .",
        "5": ". . . . . . . . . . . . . . . .",
        "6": ". . . . . . b . . . . . . . . .",
        "7": ". . . p . . . . . . . . 1 . . .",
        "8": ". . . . . . . . . . . . . . . .",
        "9": ". . . . . . . . . . . . . . . .",
        "A": ". . . . . . . . . . . . . . . .",
        "B": ". . . . . . . . . . . . . . . .",
        "C": ". . . . . . . . . . . . . . . .",
        "D": ". . . . . . . . . . . . . . . .",
        "E": ". . . . . . . . . . . . . . . .",
        "F": ". . . . . . . . . . . . . . . ."
    }
}
