{
  "winningPoints": 4,
  "lower": {
    "_": "0 1 2 3 4 5 6 7 8 9 A B C D E F",
    "0": ". . . . . . . . . . . . . . . .",
    "1": ". . . . . . . . . . . . . . . .",
    "2": ". . . . . . . . . . . . . . . .",
    "3": ". . . . . . . . . . . s s . . .",
    "4": ". . . . . . . . . . . s s . . .",
    "5": ". . . . . . . . . . . s s . . .",
    "6": ". . . . . . . . . . . s s . . .",
    "7": ". . . s s s s s s s s s s . . .",
    "8": ". . . s s s s s s s s s s . . .",
    "9": ". . . . . . . . . . . s s . . .",
    "A": ". . . . . . . . . . . s s . . .",
    "B": ". . . . . . . . . . . s s . . .",
    "C": ". . . . . . . . . . . s s . . .",
    "D": ". . . . . . . . . . . . . . . .",
    "E": ". . . . . . . . . . . . . . . .",
    "F": ". . . . . . . . . . . . . . . ."
  },
  "upper": {
    "_": "0 1 2 3 4 5 6 7 8 9 A B C D E F",
    "0": ". . . . . . . . . . . . . . . .",
    "1": ". . . . . . . . . . . . . . . .",
    "2": ". . . . . . . . . . . . . . . .",
    "3": ". . . . . . . . . . . . . 1 . .",
    "4": ". . . . . . . . . . . . . . . .",
    "5": ". . . . . . . . . . . . . . . .",
    "6": ". . . . . . . . . . . . . 1 . .",
    "7": ". . . p . . . b . . . b . . . .",
    "8": ". . . . . b . . . b . . . . . .",
    "9": ". . . . . . . . . . . . . 1 . .",
    "A": ". . . . . . . . . . . . . . . .",
    "B": ". . . . . . . . . . . . . . . .",
    "C": ". . . . . . . . . . . . . 1 . .",
    "D": ". . . . . . . . . . . . . . . .",
    "E": ". . . . . . . . . . . . . . . .",
    "F": ". . . . . . . . . . . . . . . ."
  }
}
