{
    "winningPoints": 4,

    "lower": {
        "_": "0 1 2 3 4 5 6 7 8 9 A B C D E F",
        "0": ". . . . . . . . . . . . . . . .",
        "1": ". . . . . . . . . . . . . s . .",
        "2": ". . . . . . . . . . . . . . . .",
        "3": ". . . s s b s s . . . . s . . .",
        "4": ". . . s . . s s . . . . s s . .",
        "5": ". . . s s s s s . s s s s s . .",
        "6": ". . . . . . . . . . . . . . . .",
        "7": ". . . . . . . . s . . . . . . .",
        "8": ". . . . . . s s s . s s s . . .",
        "9": ". . . . . . s s s . s s s . . .",
        "A": ". . . . . . s s s . s s s . . .",
        "B": ". . . . . . . . . . . . . . . .",
        "C": ". . . . . . . . . . . . . . . .",
        "D": ". . . . . . . . . . . . . . . .",
        "E": ". . . . . . . . . . . . . . . .",
        "F": ". . . . . . . . . . . . . . . ."
    },

    "upper": {
        "_": "0 1 2 3 4 5 6 7 8 9 A B C D E F",
        "0": ". . . . . . . . . . . . . . . .",
        "1": ". . . . . . . . . . . . . 1 . .",
        "2": ". . . . . . . . . . . . . . . .",
        "3": ". . . . . . . . . . . . . p . .",
        "4": ". . . . B . . . . . . . . . . .",
        "5": ". . . . . b . 1 . . . . . b . .",
        "6": ". . . . . . . . . . . . . . . .",
        "7": ". . . . . . . . . . . . . . . .",
        "8": ". . . . . . . . . . . b . . . .",
        "9": ". . . . . . 1 B . . B b 1 . . .",
        "A": ". . . . . . . . . . . . . . . .",
        "B": ". . . . . . . . . . . . . . . .",
        "C": ". . . . . . . . . . . . . . . .",
        "D": ". . . . . . . . . . . . . . . .",
        "E": ". . . . . . . . . . . . . . . .",
        "F": ". . . . . . . . . . . . . . . ."
    }
}
