{
    "winningPoints": 8,

    "lower": {
        "_": "0 1 2 3 4 5 6 7 8 9 A B C D E F",
        "0": ". . . . . . . . . . . . . . . .",
        "1": ". . . . . s s s s . . . . . . .",
        "2": ". . . s s s s s s s s s s . . .",
        "3": ". . . s s s s s s s s s s . . .",
        "4": ". . . s s s s s . s s s s . . .",
        "5": ". . . s s s s s s s s s s . . .",
        "6": ". . . s s s s s s s s s s . . .",
        "7": ". . . s s s s s s s s s s . . .",
        "8": ". . . s s s s s s s s s s . . .",
        "9": ". . . s s s s s s s s s s . . .",
        "A": ". . . s s s s s s s s s s . . .",
        "B": ". . . . . . . . . . . . . . . .",
        "C": ". . . . . . . . . . . . . . . .",
        "D": ". . . . . . . . . . . . . . . .",
        "E": ". . . . s s s . . . . . . . . .",
        "F": ". . . . . . . . . . . . . . . ."
    },

    "upper": {
        "_": "0 1 2 3 4 5 6 7 8 9 A B C D E F",
        "0": ". . . . . . . . . . . . . . . .",
        "1": ". . . . . s s s s . . . . . . .",
        "2": ". . . s s s . . s s s s s . . .",
        "3": ". . . s 1 b 1 . s . . 1 s . . .",
        "4": ". . . s B . . . . . . b s . . .",
        "5": ". . . s 1 b 1 . s . . 1 s . . .",
        "6": ". . . s s s . . s s b s s . . .",
        "7": ". . . . . s s s s . . . . . . .",
        "8": ". . . . . . . . p . . . . . . .",
        "9": ". . . . . . . . . . . b . . . .",
        "A": ". . . . . . . . . . . . . . . .",
        "B": ". . . . . . . . . . . . . . . .",
        "C": ". . . . . . . . . . . . . . . .",
        "D": ". . . . . . . . . . . . . . . .",
        "E": ". . . . 1 . 1 . . . . . . . . .",
        "F": ". . . . . . . . . . . . . . . ."
    }
}
