{
  "winningPoints": 100,
  "lower": {
    "_": "0 1 2 3 4 5 6 7 8 9 A B C D E F",
    "0": ". . . . . . . . . . . . . . . .",
    "1": ". . . . . . . . . . . . . . . .",
    "2": ". . . s s s s s s s s s s . . .",
    "3": ". . . s s s s s s s s s s . . .",
    "4": ". . . s s s s s s s s s s . . .",
    "5": ". . . s s s s s s s s s s . . .",
    "6": ". . . s s s s s s s s s s . R .",
    "7": ". . . s s s s s s s s s s . . .",
    "8": ". . . s s s s s s s s s s . r .",
    "9": ". . . s s s s s s . s s s . . .",
    "A": ". . . s s s s s s s . s s . . .",
    "B": ". . . s s s s s s s s . s . . .",
    "C": ". . . s s s s s s s s s . . . .",
    "D": ". . . . . . . . . . . . . . . .",
    "E": ". . . . . . . . . . . . . . . .",
    "F": ". . . . . . . . . . . . . . . ."
  },
  "upper": {
    "_": "0 1 2 3 4 5 6 7 8 9 A B C D E F",
    "0": ". . . . . . . . . . . . . . . .",
    "1": ". . . . . . . . . . . . . . . .",
    "2": ". . . . . . . . . . . . . . . .",
    "3": ". . . . . . . . . . . . . . . .",
    "4": ". . . s . b . . r . r . . . . .",
    "5": ". . . . . b . . . r . . . . . .",
    "6": ". . . . . . p . . . r . . . . .",
    "7": ". . s s . b . . . . . . . . . .",
    "8": ". . s s . . . . . . . . . . . .",
    "9": ". . . s . . r r r . . . . . . .",
    "A": ". . . s s s . . . . . . . . . .",
    "B": ". . . . . . . . . . . . . . . .",
    "C": ". . . . . . s . . . . . . . . .",
    "D": ". . . . . . . s . . . . . . . .",
    "E": ". . . . . . . . . . . . . . . .",
    "F": ". . . . . . . . . . . . . . . ."
  }
}
