{
    "winPoints": 7,

    "lower": {
        "_": "0 1 2 3 4 5 6 7 8 9 A B C D E F",
        "0": ". . . . . . . . . . . . . . . .",
        "1": ". . . . . . . . . . . . . . . .",
        "2": ". . . . . . . . . . . . . . . .",
        "3": ". . s s s s s s s s s s s . . .",
        "4": ". . s s s s s s s s s s s . . .",
        "5": ". . s s s s s s s s s s s . . .",
        "6": ". . s s s s s s s s s s s . . .",
        "7": ". . s s s s s s s s s s s . . .",
        "8": ". . s s s s s s s s s s s . . .",
        "9": ". . s s s s s s s s s s s . . .",
        "A": ". . s s s s s s s s s s s . . .",
        "B": ". . s s s s s s s s s s s . . .",
        "C": ". . s s s s s s s s s s s . . .",
        "D": ". . . . . . . . . . . . . . . .",
        "E": ". . . . . . . . . . . . . . . .",
        "F": ". . . . . . . . . . . . . . . ."
    },
    "upper": {
        "_": "0 1 2 3 4 5 6 7 8 9 A B C D E F",
        "0": ". . . . . . . . . . . . . . . .",
        "1": ". . . . . . . . . . . . . . . .",
        "2": ". . . . . . . . . . . . . . . .",
        "3": ". . . . . . . . s . . . . . . .",
        "4": ". . . . . . B . s . . . . . . .",
        "5": ". . . . . . . . s . 1 . . . . .",
        "6": ". . . . . . . . s . . . . . . .",
        "7": ". . . p . . b . s . 5 . . . . .",
        "8": ". . . . . . . . s . . . . . . .",
        "9": ". . . . . . . . s . 1 . . . . .",
        "A": ". . . b . . b . s . . . . . . .",
        "B": ". . . . . . . . s . . . . . . .",
        "C": ". . . . . . . . s . . . . . . .",
        "D": ". . . . . . . . . . . . . . . .",
        "E": ". . . . . . . . . . . . . . . .",
        "F": ". . . . . . . . . . . . . . . ."
    }
}

