{
    "lower": {
        "_": "0|1|2|3|4|5|6|7|8|9|A|B|C|D|E|F",
        "0": " . . . . . . . . . . . . . . . ",
        "1": " . . . . . . . . . . . . . . . ",
        "2": " . . . . . . . . . . . . . . . ",
        "3": " . . . . . . . . . . . . . . . ",
        "4": " . . . . . . . . . . . . . . . ",
        "5": " . . . . .s.s.s.s.s.s. . . . . ",
        "6": " . . . . .s.s.s.s.s.s. . . . . ",
        "7": " . . . . .s.s.s.s.s.s. . . . . ",
        "8": " . . . . .s.s.s.s.s.s. . . . . ",
        "9": " . . . . .s.s.s.s.b.s. . . . . ",
        "A": " . . . . .s.s.s.s.s.s. . . . . ",
        "B": " . . . . . . . . . . . . . . . ",
        "C": " . . . . . . . . . . . . . . . ",
        "D": " . . . . . . . . . . . . . . . ",
        "E": " . . . . . . . . . . . . . . . ",
        "F": " . . . . . . . . . . . . . . . "
    },
    "upper": {
        "_": "0|1|2|3|4|5|6|7|8|9|A|B|C|D|E|F",
        "0": " . . . . . . . . . . . . . . . ",
        "1": " . . . . . . . . . . . . . . . ",
        "2": " . . . . . . . . . . . . . . . ",
        "3": " . . .s.s.s. . . . . . . . . . ",
        "4": " . . .b.5.s. . . . . . . . . . ",
        "5": " . . .s.s.s.s.s. . . . . . . . ",
        "6": " . . . . .s. . . .b. . . . . . ",
        "7": " . . . . .s. .p. . . . . . . . ",
        "8": " . . . . . . . . . . . . . . . ",
        "9": " . . . . . . . . . . . . . . . ",
        "A": " . . . . . . . . . . . . . . . ",
        "B": " . . . . . . . . . . . . . . . ",
        "C": " . . . . . . . . . . . . . . . ",
        "D": " . . . . . . . . . . . . . . . ",
        "E": " . . . . . . . . . . . . . . . ",
        "F": " . . . . . . . . . . . . . . . "
    }
}

