{
    "lower": {
        "_": "0|1|2|3|4|5|6|7|8|9|A|B|C|D|E|F",
        "0": " . . . . . . . . . . . . . . . ",
        "1": " . . . . . . . . . . . . . . . ",
        "2": " . . . . . . . . . . . . . . . ",
        "3": " . .s.s.s.s. . . . . . . . . . ",
        "4": " . .s. . .s. . . . . . . . . . ",
        "5": " . . . . .b. . . . . . . . . . ",
        "6": " . .s.s.s.s. .s. . . . . . . . ",
        "7": " . .s.s.s.s. . . . . . . . . . ",
        "8": " . .s.s.s.s. . . . . . . . . . ",
        "9": " . .s.s.s.s. .s. . . . . . . . ",
        "A": " . . . . . . . . . . . . . . . ",
        "B": " . . . . . . . . . . . . . . . ",
        "C": " . . . . . . . . . . . . . . . ",
        "D": " . . . . . . . . . . . . . . . ",
        "E": " . . . . . . . . . . . . . . . ",
        "F": " . . . . . . . . . . . . . . . "
    },
    "upper": {
        "_": "0|1|2|3|4|5|6|7|8|9|A|B|C|D|E|F",
        "0": " . . . . . . . . . . . . . . . ",
        "1": " . . . . . . . . . . . . . . . ",
        "2": " . . . . . . . . . . . . . . . ",
        "3": " . . . . . . . . . . . . . . . ",
        "4": " . .5. . . . . . . . . . . . . ",
        "5": " . . . . . . . . . . . . . . . ",
        "6": " . .p. . .b. . . . . . . . . . ",
        "7": " . . . . . . . . . . . . . . . ",
        "8": " . . . . . . . . . . . . . . . ",
        "9": " . .B.B.B.B. . . . . . . . . . ",
        "A": " . . . . . . . . . . . . . . . ",
        "B": " . . . . . . . . . . . . . . . ",
        "C": " . . . . . . . . . . . . . . . ",
        "D": " . . . . . . . . . . . . . . . ",
        "E": " . . . . . . . . . . . . . . . ",
        "F": " . . . . . . . . . . . . . . . "
    }
}
